0
xxxxxxxxxxxxxxxxxxxxxxxxxxx xxxxxxx
xx       x             x    x     x
x    x       x             x  x x x
x             x  x          x     x
x  x     x x                      x
x       x           x             x
x x S     x                x      x
x                x        x  x    x
xx      x      x      x        x xx
x      x  x       x        x      x
x  x     x  x        x    x       x
x      x        x       x         x
x x                   x      x  x x
x     x  x       x                x
xxxxxxxxxxxxxxxxxxxxxxxxxxxxxxxxxxx