7
2 29 -12
3 2 -13
9 9 -17
14 15 -25
14 30 -51
21 4 -5
23 31 -500
xxxxxxxxxxxxxxxxxxxxxxxxxxxxxxxxxxx
x          x     S          x     x
x  x     x       x       x   + x  x
x +  x x     x x   x x       x    x
x   x      x            x         x
x x       x      x       x     x  x
x                                 x
x          x x x    x             x
xx     x                x    x x  x
x        +           x     x      x
x   x              x  x        x  x
x     x                 x         x
x  x    x      x x               xx
x      x           x       x      x
x           x  +     x  x     +   x
xx       x                    x   x
x          x   x        x   x     x
        x            x        x   x
x           x     x               x
x    x    x                x   x  x
xx  x x        x       x     x    x
x   +   x                  x      x
x     x   x  x     x   x x    x   x
x x     x      x     x         +  x
xxxxxxxxxxxxxxxxxxxxxxxxxxxxxxxxxxx